################################################
#                      P                       #
#                                              #
#                      X                       #
#                      O                       #
#                                              #
#                                              #
#                                              #
#                                              #
#                                              #
#                                              #
#                                              #
#                                              #
#                                              #
#                                              #
#                                              #
#                                              #
################################################